wwwwwwwwwwwwwwwwwwwwwwwwwwwwwwwwwwwww
w...................................w
wh..................................w
wh..................................w
wh..................................w
wh.....w.........w..wwwowww..wwwww..w
wh......w...w...w......w.....www....w
wh.......w.w.w.w.......w.....w......w
wh........w...w........w.....w......w
wh..................................w
wh..................................w
wh....w...w...........w...w.........w
wh....w...w.....w.....w...w.....w...w
wh....wwwww....w.w....wwwww....w.w..w
wh....w...w...w.w.w...w...w...w.w.w.w
wh....w...w..w.....w..w...w..w.....ww
wh................................i.w
wwwwwwwwwwwwwwwwwwwwwwwwwwwwwwwwwwwww
