wwwwwwwwwwwwwwwwwwwwwwwwww
w....s..s.....s.........ow
w.......s.....s........www
w........m....s.......wwww
wswwwwwwwwwwwwwwwwwwwswwww
ws....s.......s..........w
ws.......m...............w
wwwwwwwwwwwwwwwwwwwwwswwsw
w.....s.......s......s..sw
w........m...........s..sw
wswwwwwwwwwwwwwwwwwww.wwww
ws....s.......s....s.....w
ws....s.......s..........w
ws.......m...........sw..w
wwwwwwwwwwwwwwwwwwww.sw..w
wi...................swwkw
wwwwwwwwwwwwwwwwwwwwwwwwww