wwwwwwwwwwwwwwwwwwwwwwwwwwwwwwwwwwwwwwwwwwwwwwwwwwwww
w......................w..k..w......................w
w......................wwwswww......................w
w.........................s.........................w
w..swwwwwwwwwwwwwww.......s.......wwwwwwwwwwwwwwws..w
w..s...............ww.w.w.w.w.w.ww...............s..w
w..s.............................................s..w
wwwwwwwwwwwwwwwwwww...............wwwwwwwwwwwwwwwwwww
w..................ww...........ww..................w
w....................ww.......ww....................w
w......................ww.m.ww......................w
w........................wsw........................w
w.........................s.........................w
w.........................s.........................w
w.........................s.........................w
w.........................s.........................w
wwwwwwwwwwwwwswwwwwwwwwwwwwwwwwwwwwwwwwswwwwwwwwwwwww
w............s.........................s............w
w............s.........................s............w
w............s.........................s............w
w............s.........................s............w
w............s.........................s............w
w............s.........................s............w
w..........wwwwwwwwwwwwwwwwwwwwwwwwwwwwwww..........w
w........wwwwwwwwwwwwwwwwwwwwwwwwwwwwwwwwwww........w
w......wwwwwwwwwwwwwwwwwwwwwwwwwwwwwwwwwwwwwww......w
w....wwwwwwwwwwwwwwwwwwwwwwwwwwwwwwwwwwwwwwwwwww....w
wi.wwwwwwwwwwwwwwwwwwwwwwwwwwwwwwwwwwwwwwwwwwwwwww.ow
wwwwwwwwwwwwwwwwwwwwwwwwwwwwwwwwwwwwwwwwwwwwwwwwwwwww
